111111111111111111
10010000000C000001
1000011110000N0001
1P0011E00000000001
1000000000N0000001
100C00000000000001
100000000000N00001
10000000C000000001
10000000000N000001
100N00000000000001
100000000C00000001
10000000000000C001
111111111111111111
