111111111
10PE0C001
100E00001
111111111
