111111111
1P00CE001
1NNNNNN01
1NNN00NN1
1NNNNNNN1
111111111
