11111111111111111111111111111111111111111111111111111
100000000000000000EC000000000000000000000000000000001
1000000000000000000C000000000000000000000000000000001
1000000000000000000C000000000000000000000000000000001
1000000000000000000C000000000000000000000000000000001
1000000000000000000C000000000000000000000000000000001
1000000000000000000C000000000000000000000000000000001
1000000000000000000C000000000000000000000000000000001
1000000000000000000C000000000000000000000000000000001
1000000000000000000C000000000000000000000000000000001
1000000000000000000C000000000000000000000000000000001
1000000000000000000C000000000000000000000000000000001
1000000000000000000C000000000000000000000000000000001
1000000000000000000C000000000000000000000000000000001
1000000000000000000C000000000000000000000000000000001
1000000000000000000C000000000000000000000000000000001
1000000000000000000C000000000000000000000000000000001
1000000000000000000C000000000000000000000000000000001
1000000000000000000C000000000000000000000000000000001
1000000000000000000C000000000000000000000000000000001
1000000000000000000C000000000000000000000000000000001
1000000000000000000C000000000000000000000000000000001
1000000000000000000C000000000000000000000000000000001
1000000000000000000C000000000000000000000000000000001
1000000000000000000C000000000000000000000000000000001
1000000000000000000C000000000000000000000000000000001
1000000000000000000C000000000000000000000000000000001
1000000000000000000C000000000000000000000000000000001
1000000000000000000C000000000000000000000000000000001
1000000000000000000C000000000000000000000000000000001
1000000000000000000C000000000000000000000000000000001
1000000000000000000C000000000000000000000000000000001
1000000000000000000C000000000000000000000000000000001
1000000000000000000C000000000000000000000000000000001
1000000000000000000C000000000000000000000000000000001
1000000000000000000C000000000000000000000000000000001
1000000000000000000C000000000000000000000000000000001
1000000000000000000C000000000000000000000000000000001
1000000000000000000C000000000000000000000000000000001
1000000000000000000C000000000000000000000000000000001
100000000000000000PC000000000000000000000000000000001
1000000000000000000C000000000000000000000000000000001
1000000000000000000C000000000000000000000000000000001
1000000000000000000C000000000000000000000000000000001
1000000000000000000C000000000000000000000000000000001
11111111111111111111111111111111111111111111111111111
