11111111111
100001111111111111111111111111111111111
1ECP011111111111
1111111111111111111111111111111111111111111111
